PPPPPPK KK KK KPKKKKPPP
PPPPPPKPKP P P PKP PPPP
PKKKKPK K KKK KKKK KKKP
PKPPKPKPKPKPKP PKP PKPP
PKKKK KK K  K  KKKKKKKP
P PK PKPKPKPKP PKPKPKPP
PK P  KK K K  K    KKKP
P K KPKP PKP P P PKPKPP
PP PKPKKKK K K K K K  P
P   K KPKP P PKP P PKPP
PPKP PK   K K K KKKK  P
P    PKPKPKPKPKPKPKPKKP
PPKPKKKP PKPKPKPKPKPKPP
